###########
#.#.......#
#.#..######
#.#..#.@..#
#....#....#
#.#..#....#
#....#....#
#.#..#..#.#
#.#..#.##.#
#.#.......#
###########