##########
##..#...@#
#.#..#...#
#..#...#.#
##..#....#
#.#..#...#
#..#..#..#
#...#..#.#
#........#
##########
