##########
#........#
#.######.#
#.#......#
#.#.###..#
#.#..@#..#
#.#####..#
#.#...#..#
#........#
##########